1,1,1,1,1,1,1,1,1,1,1,1,1,1,1,1,1,1,1,1,1,1,1,1,1,1,1,1,1,1,
1,8,0,0,0,0,0,0,0,0,0,0,1,1,1,1,1,1,1,1,1,1,1,1,1,1,1,1,1,1,
1,1,10,10,10,1,0,2,0,1,0,0,1,1,1,0,0,1,6,0,0,0,0,0,0,0,0,0,0,1,
1,1,1,1,1,1,0,2,1,1,3,3,1,0,0,0,0,0,0,0,0,0,0,5,0,0,0,0,0,1,
1,1,10,10,10,0,0,2,0,0,0,0,1,0,0,0,1,0,0,1,1,1,1,1,1,1,10,0,0,1,
1,1,10,10,10,0,0,2,0,1,1,0,1,3,1,0,10,0,1,1,0,0,0,0,0,10,10,0,0,1,
1,1,10,1,10,0,0,2,0,1,1,0,1,13,1,0,1,0,1,1,10,10,10,3,3,1,10,0,0,1,
1,1,10,1,10,0,0,2,0,1,1,1,1,1,1,0,0,0,1,1,1,1,13,0,0,12,1,0,0,1,
1,1,10,1,10,0,0,2,0,1,0,0,3,12,0,0,0,0,1,1,1,1,4,0,0,0,1,0,0,1,
1,1,10,1,10,0,0,2,0,1,0,0,3,0,0,0,0,0,1,1,1,1,0,0,0,0,1,0,0,1,
1,1,1,1,2,0,0,1,0,0,3,0,0,0,0,0,1,0,0,1,11,0,0,4,0,0,2,5,0,1,
2,7,0,0,2,0,0,1,0,0,3,0,0,0,0,0,1,0,0,1,0,0,0,0,0,0,2,0,0,1,
2,0,0,0,2,0,0,1,1,1,1,1,1,1,1,1,1,0,0,1,0,0,3,3,0,0,2,3,3,1,
2,0,0,0,2,0,0,0,0,0,0,4,0,0,0,0,0,0,0,1,0,0,0,0,0,0,2,0,0,1,
2,0,2,0,2,0,0,0,0,0,0,0,0,0,0,0,0,0,10,1,0,0,4,0,0,6,2,0,0,1,
2,0,2,0,2,0,4,0,0,0,0,0,0,0,0,0,0,10,10,1,0,0,0,0,0,0,2,0,0,1,
2,0,2,0,2,1,1,1,1,1,1,1,1,1,1,1,1,1,1,1,1,0,0,0,0,0,2,2,0,1,
2,0,2,0,2,2,2,2,2,2,2,2,2,2,2,2,2,10,10,10,10,0,0,3,3,0,2,0,0,1,
2,0,2,0,2,2,2,10,10,10,10,10,10,10,10,10,10,2,2,2,2,2,0,0,0,0,0,0,0,1,
2,0,2,0,0,0,7,1,0,1,13,1,0,1,12,1,0,1,0,1,10,10,10,10,10,10,0,0,0,1,
2,0,2,0,0,0,0,0,0,0,0,2,1,0,0,0,0,0,0,0,2,2,2,2,2,2,2,2,0,1,
2,0,2,0,0,0,5,0,0,0,0,2,1,0,0,0,0,0,0,0,7,0,0,0,0,0,0,0,0,1,
2,0,2,0,0,0,0,0,0,0,0,2,1,0,0,0,0,0,0,0,0,0,0,0,0,0,5,0,0,1,
2,0,2,10,0,0,3,3,10,10,10,2,1,14,0,0,0,0,0,0,0,0,0,0,0,0,0,0,0,1,
2,0,2,10,10,10,0,0,10,10,10,10,10,2,1,0,0,5,3,0,0,0,2,2,2,2,2,2,2,1,
1,0,2,1,1,10,0,0,0,2,10,10,2,1,0,0,0,0,3,0,0,0,0,0,0,3,0,10,10,1,
1,0,0,2,1,10,0,0,0,2,2,2,2,1,0,0,0,0,3,0,0,0,0,0,0,3,0,0,6,1,
1,0,0,2,1,10,0,0,0,0,0,0,0,0,0,4,0,0,0,0,0,0,4,0,0,3,11,0,10,1,
1,15,0,2,1,10,0,0,0,0,0,0,0,0,0,0,0,0,0,0,0,0,0,0,0,3,0,10,10,1,
1,1,1,1,1,1,1,1,1,1,1,1,1,1,1,1,1,1,1,1,1,1,1,1,1,1,1,1,1,1,
