1,1,1,1,1,1,1,1,1,1,1,1,1,1,1,1,1,1,1,1,1,1,1,1,1,1,1,1,1,1,1,1,1,1,1,1,1,1,1,1,
1,8,0,0,0,0,0,0,0,0,0,3,0,6,0,0,0,0,0,0,6,0,0,0,0,0,0,0,0,0,0,0,3,0,0,0,0,0,0,1,
1,0,0,0,0,0,0,0,0,0,0,3,0,0,0,0,0,0,0,0,0,0,0,0,0,2,2,2,2,0,0,0,3,0,0,0,0,0,0,1,
1,2,2,2,2,2,2,2,2,2,2,2,2,2,0,0,0,2,2,2,2,2,2,2,2,0,0,0,2,2,2,2,2,2,2,2,2,0,0,1,
1,0,0,0,0,0,0,0,0,0,0,0,0,0,0,0,0,0,0,0,0,0,0,0,0,0,0,0,2,0,0,6,0,10,10,10,2,0,0,1,
1,0,0,6,0,0,0,0,0,0,0,0,0,0,0,0,0,0,0,0,11,0,0,0,0,0,0,0,2,0,0,0,0,0,10,10,2,5,0,1,
1,0,0,2,2,2,2,2,2,2,2,2,2,2,2,2,2,2,2,2,2,2,2,2,2,2,2,2,2,0,0,0,0,0,10,10,2,0,0,1,
1,0,0,2,0,0,0,0,0,0,0,3,0,0,0,0,0,0,0,0,3,0,0,0,12,0,0,0,0,4,0,0,0,0,0,10,2,0,0,1,
1,0,0,2,10,0,0,0,0,0,0,3,0,0,0,4,0,0,0,0,3,0,0,0,0,0,0,0,0,0,0,0,0,0,0,2,2,3,3,1,
1,0,0,2,10,0,0,5,0,0,0,3,0,0,0,0,0,0,0,0,3,0,0,0,0,0,0,0,0,0,0,13,0,0,2,2,2,0,0,1,
1,0,0,2,10,0,0,0,0,0,0,0,0,0,0,0,0,10,10,0,3,0,0,0,0,0,5,0,0,0,0,0,0,2,2,0,2,0,0,1,
1,0,0,2,10,0,0,0,0,0,0,0,13,0,10,10,10,10,0,0,3,0,10,10,10,0,0,0,0,0,0,0,0,2,0,0,2,0,0,1,
1,7,0,2,10,3,3,3,0,0,0,0,0,10,10,10,2,2,2,2,2,2,2,10,10,0,0,0,2,0,0,0,0,2,0,0,2,0,0,1,
1,0,0,2,10,3,0,0,0,0,0,0,10,10,2,2,2,0,0,0,0,0,2,2,10,0,0,0,2,0,0,0,2,2,0,0,2,0,0,1,
1,0,0,2,11,3,0,4,0,0,10,10,10,2,2,0,0,0,0,3,0,12,0,2,2,0,0,0,2,2,0,0,2,0,0,0,2,0,0,1,
1,0,0,2,12,0,0,0,0,10,10,2,2,11,0,0,0,0,0,3,0,0,0,2,0,0,0,0,0,2,3,3,0,0,0,0,2,10,0,1,
1,0,0,2,10,0,0,0,0,10,2,2,0,0,0,0,0,3,3,3,0,0,0,2,0,0,0,0,0,2,3,3,0,0,0,0,2,10,0,1,
1,0,0,2,10,0,0,0,0,10,2,0,0,0,0,0,0,0,0,0,0,0,0,2,0,0,0,0,0,2,0,0,0,0,0,0,2,10,13,1,
1,0,0,2,10,0,0,0,0,10,2,0,0,0,4,0,0,2,2,2,2,2,2,2,0,0,0,4,0,2,0,0,0,0,0,2,2,3,3,1,
1,0,7,2,10,0,0,0,0,10,2,0,0,0,0,0,0,0,0,0,0,0,0,2,0,0,0,0,0,2,0,0,0,0,0,2,0,0,0,1,
1,0,0,2,10,0,5,0,0,10,2,0,0,0,2,0,0,0,0,0,0,0,0,2,0,3,3,3,0,2,0,0,5,0,0,2,0,0,0,1,
1,0,0,2,10,0,0,0,0,10,2,0,0,2,2,0,0,0,0,4,0,0,0,2,0,0,0,0,0,2,0,0,0,0,0,2,0,0,0,1,
1,0,0,2,10,0,0,0,0,10,2,0,0,2,0,0,0,0,0,0,0,0,2,2,0,0,0,0,0,2,0,0,0,0,0,2,0,0,5,1,
1,0,0,2,10,0,0,4,0,10,2,0,0,2,0,0,2,2,2,2,2,2,2,0,0,0,5,0,0,2,0,0,0,0,0,2,2,0,0,1,
1,0,0,2,2,2,0,0,0,10,2,0,0,2,0,0,2,10,10,10,11,0,3,3,0,0,0,0,0,2,0,6,0,0,0,0,2,0,0,1,
1,0,0,0,0,0,0,0,0,10,2,0,0,2,0,0,2,10,10,0,0,0,3,3,2,2,2,2,2,2,2,2,2,2,2,2,2,0,0,1,
1,0,4,0,0,0,0,0,0,10,2,0,0,2,0,0,2,10,10,0,0,0,0,2,0,0,0,0,0,0,0,0,0,3,0,0,2,0,0,1,
1,10,0,0,0,0,0,0,0,10,2,0,0,2,0,0,2,10,0,0,5,0,0,2,0,0,0,0,0,0,0,0,3,3,0,0,2,0,0,1,
1,10,10,10,10,10,0,0,0,10,2,0,0,2,0,0,2,0,0,0,0,0,0,2,0,0,0,0,0,0,0,0,3,0,0,0,2,0,0,1,
1,2,2,2,2,10,0,0,0,10,2,0,0,2,0,0,2,0,0,12,0,0,0,2,0,0,0,2,2,2,2,2,3,0,0,0,2,0,0,1,
1,0,0,0,2,2,0,0,0,10,2,0,0,2,0,0,0,2,0,0,0,0,0,2,0,0,0,2,0,0,0,2,0,0,10,10,2,0,0,1,
1,0,0,0,0,2,0,5,0,10,2,0,0,0,2,0,0,2,0,0,0,4,0,2,0,5,0,2,0,0,0,2,0,0,10,10,2,0,0,1,
1,0,13,0,11,2,0,0,0,10,2,0,0,0,2,0,0,2,0,14,0,0,0,2,0,0,0,2,0,0,0,2,0,10,10,10,2,0,0,1,
1,0,0,0,2,2,0,0,0,10,2,0,0,0,2,0,0,2,0,0,0,0,0,2,0,0,0,2,0,0,0,2,0,2,2,2,2,0,0,1,
1,3,3,3,2,2,0,0,0,10,2,0,4,0,2,0,0,2,2,0,0,0,2,2,0,0,0,2,0,0,0,2,0,2,0,0,0,5,0,1,
1,0,0,0,0,0,0,0,0,0,2,0,0,0,2,3,3,3,2,2,2,2,2,0,0,0,0,2,0,0,0,2,0,2,0,0,0,0,0,1,
1,0,0,0,0,0,0,0,0,0,0,0,0,0,2,0,0,0,0,0,0,0,0,0,0,0,2,2,0,0,0,2,0,2,10,10,10,0,0,1,
1,0,0,0,0,0,0,0,0,0,5,0,0,0,2,0,0,0,0,0,0,0,0,3,0,0,2,0,0,0,0,2,0,2,0,0,10,0,0,1,
1,0,0,0,0,0,5,0,0,0,0,0,0,0,2,0,0,0,0,0,0,0,0,3,0,0,2,0,0,0,0,2,15,2,14,0,10,0,0,1,
1,1,1,1,1,1,1,1,1,1,1,1,1,1,1,1,1,1,1,1,1,1,1,1,1,1,1,1,1,1,1,1,1,1,1,1,1,1,1,1,
